start,0,0,,,,,,,
goal,6,9,,,,,,,
0,0,0,0,0,0,0,0,1,0,0
0,1,1,1,1,0,0,0,1,0,0
0,0,0,0,0,0,0,0,1,0,0
0,0,0,1,1,1,1,1,1,0,0
0,1,0,1,0,0,0,0,0,0,0
0,1,0,1,0,1,1,1,1,0,0
0,1,0,0,0,1,1,1,1,0,0
0,1,1,1,0,0,0,1,1,0,0
0,0,0,0,0,0,0,1,0,0,0
0,0,0,0,0,0,0,0,0,0,0
